Metallschrottrecyclingunternehmen	Metall<NN>Schrott<NN>Recycling<NN>Unternehmen<NN>	Len=4
Raketenantriebsforschungslabor	Rakete<NN>Antrieb<NN>Forschung<NN>Labor<NN>	Len=4
Luftverkehrsrechtsexperte	Luft<NN>Verkehr<NN>Recht<NN>Experte<NN>	Len=4
Hautkrebsrisikogruppe	Haut<NN>Krebs<NN>Risiko<NN>Gruppe<NN>	Len=4
Reiserücktrittskostenversicherung	Reise<NN>Rücktritt<NN>Kosten<NN>Versicherung<NN>	Len=4
Stadtjugendfeuerwehrwart	Stadt<NN>Jugend<NN>Feuerwehr<NN>Wart<NN>	Len=4
Raumflugkontrollzentrum	Raum<NN>Flug<NN>Kontrolle<NN>Zentrum<NN>	Len=4
Blutdruckzielwert	Blut<NN>Druck<NN>Ziel<NN>Wert<NN>	Len=4
Atomteststoppabkommen	Atom<NN>Test<NN>Stopp<NN>Abkommen<NN>	Len=4
Holzschuhtanzgruppe	Holz<NN>Schuh<NN>Tanz<NN>Gruppe<NN>	Len=4
Kriegsmaterialausfuhrgesetz	Krieg<NN>Material<NN>Ausfuhr<NN>Gesetz<NN>	Len=4
Seifenblasenzielwettbewerb	Seife<NN>Blase<NN>Ziel<NN>Wettbewerb<NN>	Len=4
Landesklimaschutzgesetz	Land<NN>Klima<NN>Schutz<NN>Gesetz<NN>	Len=4
Notarztwagenbesatzung	Not<NN>Arzt<NN>Wagen<NN>Besatzung<NN>	Len=4
Haifischknorpelextrakt	Hai<NN>Fisch<NN>Knorpel<NN>Extrakt<NN>	Len=4
Plastikwindschutzscheibe	Plastik<NN>Wind<NN>Schutz<NN>Scheibe<NN>	Len=4
Landmaschinenmechanikermeister	Land<NN>Maschine<NN>Mechaniker<NN>Meister<NN>	Len=4
Abwasserdruckrohrleitung	Abwasser<NN>Druck<NN>Rohr<NN>Leitung<NN>	Len=4
Kreisvereinspokalturnier	Kreis<NN>Verein<NN>Pokal<NN>Turnier<NN>	Len=4
Ballkontaktrekordhalter	Ball<NN>Kontakt<NN>Rekord<NN>Halter<NN>	Len=4
Verkehrsunfallpräventionskonzept	Verkehr<NN>Unfall<NN>Prävention<NN>Konzept<NN>	Len=4
Arzneiwareneinfuhrgesetz	Arznei<NN>Ware<NN>Einfuhr<NN>Gesetz<NN>	Len=4
Papiertaschentuchvorrat	Papier<NN>Tasche<NN>Tuch<NN>Vorrat<NN>	Len=4
Gitterrohrrahmenkonstruktion	Gitter<NN>Rohr<NN>Rahmen<NN>Konstruktion<NN>	Len=4
Länderspieltorschütze	Land<NN>Spiel<NN>Tor<NN>Schütze<NN>	Len=4
Birkenpollenflugsaison	Birke<NN>Pollen<NN>Flug<NN>Saison<NN>	Len=4
Geschäftsreiseflugverkehr	Geschäft<NN>Reise<NN>Flug<NN>Verkehr<NN>	Len=4
Restrisikoversicherungsprämie	Rest<NN>Risiko<NN>Versicherung<NN>Prämie<NN>	Len=4
Elektronikfachmarktkette	Elektronik<NN>Fach<NN>Markt<NN>Kette<NN>	Len=4
Finanzmarktstabilitätsgesetz	Finanz<NN>Markt<NN>Stabilität<NN>Gesetz<NN>	Len=4
Windkraftanlagenhersteller	Wind<NN>Kraft<NN>Anlage<NN>Hersteller<NN>	Len=4
Seehundexpertengruppe	See<NN>Hund<NN>Experte<NN>Gruppe<NN>	Len=4
Ersatztorhüterposition	Ersatz<NN>Tor<NN>Hüter<NN>Position<NN>	Len=4
Terminmarktaufsichtsbehörde	Termin<NN>Markt<NN>Aufsicht<NN>Behörde<NN>	Len=4
Finanzmarkttransaktionsteuer	Finanz<NN>Markt<NN>Transaktion<NN>Steuer<NN>	Len=4
Notarzteinsatzfahrzeug	Not<NN>Arzt<NN>Einsatz<NN>Fahrzeug<NN>	Len=4
Tannenzapfenzielwurf	Tanne<NN>Zapfen<NN>Ziel<NN>Wurf<NN>	Len=4
Zuckerrübenerntetechnik	Zucker<NN>Rübe<NN>Ernte<NN>Technik<NN>	Len=4
Knochenmarkspendendatei	Knochen<NN>Mark<NN>Spende<NN>Datei<NN>	Len=4
Frauenfußballexpertenrunde	Frau<NN>Fußball<NN>Experte<NN>Runde<NN>	Len=4
Steinofenchampignonpizza	Stein<NN>Ofen<NN>Champignon<NN>Pizza<NN>	Len=4
Bundesverbraucherschutzministerium	Bund<NN>Verbraucher<NN>Schutz<NN>Ministerium<NN>	Len=4
Erdwärmepumpensystem	Erde<NN>Wärme<NN>Pumpe<NN>System<NN>	Len=4
Standortsicherungstarifvertrag	Standort<NN>Sicherung<NN>Tarif<NN>Vertrag<NN>	Len=4
Erdgaszweigleitung	Erde<NN>Gas<NN>Zweig<NN>Leitung<NN>	Len=4
Geldwäscheverdachtsanzeige	Geld<NN>Wäsche<NN>Verdacht<NN>Anzeige<NN>	Len=4
Waffensystemunterstützungskommando	Waffe<NN>System<NN>Unterstützung<NN>Kommando<NN>	Len=4
Tintenstrahldrucktechnologie	Tinte<NN>Strahl<NN>Druck<NN>Technologie<NN>	Len=4
Saisonauftaktspressekonferenz	Saison<NN>Auftakt<NN>Presse<NN>Konferenz<NN>	Len=4
Büromöbelverleihkette	Büro<NN>Möbel<NN>Verleih<NN>Kette<NN>	Len=4
Glasbodenboot	Glas<NN>Boden<NN>Boot<NN>	Len=3
Papiermülltonne	Papier<NN>Müll<NN>Tonne<NN>	Len=3
Energieeffizienzmesse	Energie<NN>Effizienz<NN>Messe<NN>	Len=3
Luftgitarrenband	Luft<NN>Gitarre<NN>Band<NN>	Len=3
Zeitzeugeninterview	Zeit<NN>Zeuge<NN>Interview<NN>	Len=3
Weltmachtstatus	Welt<NN>Macht<NN>Status<NN>	Len=3
Senfkornallergie	Senf<NN>Korn<NN>Allergie<NN>	Len=3
Elternkarenzzeit	Eltern<NN>Karenz<NN>Zeit<NN>	Len=3
Stahlblechhülle	Stahl<NN>Blech<NN>Hülle<NN>	Len=3
Kinderwagenkette	Kind<NN>Wagen<NN>Kette<NN>	Len=3
Jubiläumspressekonferenz	Jubiläum<NN>Presse<NN>Konferenz<NN>	Len=3
Schallschutzprogramm	Schall<NN>Schutz<NN>Programm<NN>	Len=3
Laubwaldgebiet	Laub<NN>Wald<NN>Gebiet<NN>	Len=3
Konsumelektronikmesse	Konsum<NN>Elektronik<NN>Messe<NN>	Len=3
Gewerbeflächenmanagement	Gewerbe<NN>Fläche<NN>Management<NN>	Len=3
Nachwuchsfilmpreis	Nachwuchs<NN>Film<NN>Preis<NN>	Len=3
Knochenfischembryo	Knochen<NN>Fisch<NN>Embryo<NN>	Len=3
Provinzregierungschef	Provinz<NN>Regierung<NN>Chef<NN>	Len=3
Buslinienverkehr	Bus<NN>Linie<NN>Verkehr<NN>	Len=3
Kinderflötenchor	Kind<NN>Flöte<NN>Chor<NN>	Len=3
Sonnenfleckenaktivität	Sonne<NN>Flecken<NN>Aktivität<NN>	Len=3
Naturerlebnispfad	Natur<NN>Erlebnis<NN>Pfad<NN>	Len=3
Sommerschuhmode	Sommer<NN>Schuh<NN>Mode<NN>	Len=3
Hustenbonbonproduzent	Husten<NN>Bonbon<NN>Produzent<NN>	Len=3
Agrarindustrieexperte	Agrar<NN>Industrie<NN>Experte<NN>	Len=3
Obstbaumschnitt	Obst<NN>Baum<NN>Schnitt<NN>	Len=3
Gruppenarbeitsphase	Gruppe<NN>Arbeit<NN>Phase<NN>	Len=3
Kürbiskernbrot	Kürbis<NN>Kern<NN>Brot<NN>	Len=3
Weltmädchentag	Welt<NN>Mädchen<NN>Tag<NN>	Len=3
Hochwasserschutzprojekt	Hochwasser<NN>Schutz<NN>Projekt<NN>	Len=3
Atomwaffenlabor	Atom<NN>Waffe<NN>Labor<NN>	Len=3
Firmenschlüsselverlust	Firma<NN>Schlüssel<NN>Verlust<NN>	Len=3
Straßentankstellennetz	Straße<NN>Tankstelle<NN>Netz<NN>	Len=3
Hasenzüchterverein	Hase<NN>Züchter<NN>Verein<NN>	Len=3
Hypothekenkreditvergabe	Hypothek<NN>Kredit<NN>Vergabe<NN>	Len=3
Endrundenteilnahme	Ende<NN>Runde<NN>Teilnahme<NN>	Len=3
Berufsbekleidungssparte	Beruf<NN>Bekleidung<NN>Sparte<NN>	Len=3
Finanzmarktaufsicht	Finanz<NN>Markt<NN>Aufsicht<NN>	Len=3
Babypuderduft	Baby<NN>Puder<NN>Duft<NN>	Len=3
Wochemarktangebot	Woche<NN>Markt<NN>Angebot<NN>	Len=3
Strandbadgelände	Strand<NN>Bad<NN>Gelände<NN>	Len=3
Kopfballspezialist	Kopf<NN>Ball<NN>Spezialist<NN>	Len=3
Figurentheatergeschichte	Figur<NN>Theater<NN>Geschichte<NN>	Len=3
Personalausweisinhaber	Personal<NN>Ausweis<NN>Inhaber<NN>	Len=3
Arbeitszeitbestimmung	Arbeit<NN>Zeit<NN>Bestimmung<NN>	Len=3
Meeresfrüchtespieß	Meer<NN>Frucht<NN>Spieß<NN>	Len=3
Blockflötenduo	Block<NN>Flöte<NN>Duo<NN>	Len=3
Kindermusiktheater	Kind<NN>Musik<NN>Theater<NN>	Len=3
Polstermöbelfabrik	Polster<NN>Möbel<NN>Fabrik<NN>	Len=3
Hundefußballturnier	Hund<NN>Fußball<NN>Turnier<NN>	Len=3
Uranmine	Uran<NN>Mine<NN>	Len=2
Polizeizeitung	Polizei<NN>Zeitung<NN>	Len=2
Ölporträt	Öl<NN>Porträt<NN>	Len=2
Apfelduft	Apfel<NN>Duft<NN>	Len=2
Explosionswolke	Explosion<NN>Wolke<NN>	Len=2
Erdlawine	Erde<NN>Lawine<NN>	Len=2
Silvesterkrach	Silvester<NN>Krach<NN>	Len=2
Mopsdame	Mops<NN>Dame<NN>	Len=2
Abschiedsinterview	Abschied<NN>Interview<NN>	Len=2
Badumbau	Bad<NN>Umbau<NN>	Len=2
Bronzeschmuck	Bronze<NN>Schmuck<NN>	Len=2
Satirezeitung	Satire<NN>Zeitung<NN>	Len=2
Sonntagsverkehr	Sonntag<NN>Verkehr<NN>	Len=2
Imagewechsel	Image<NN>Wechsel<NN>	Len=2
Politikergeschwätz	Politiker<NN>Geschwätz<NN>	Len=2
Fassadenglas	Fassade<NN>Glas<NN>	Len=2
Pizzateller	Pizza<NN>Teller<NN>	Len=2
Unfallbereich	Unfall<NN>Bereich<NN>	Len=2
Rentierfamilie	Rentier<NN>Familie<NN>	Len=2
Sonnenvitamin	Sonne<NN>Vitamin<NN>	Len=2
Pferderomantik	Pferd<NN>Romantik<NN>	Len=2
Strandsport	Strand<NN>Sport<NN>	Len=2
Klinikumsgelände	Klinikum<NN>Gelände<NN>	Len=2
Eignungsprofil	Eignung<NN>Profil<NN>	Len=2
Ausbildungsphase	Ausbildung<NN>Phase<NN>	Len=2
Karabinerhaken	Karabiner<NN>Haken<NN>	Len=2
Leinenwurf	Leinen<NN>Wurf<NN>	Len=2
Serienkonsum	Serie<NN>Konsum<NN>	Len=2
Opferstatus	Opfer<NN>Status<NN>	Len=2
Käsesandwich	Käse<NN>Sandwich<NN>	Len=2
Filmgelände	Film<NN>Gelände<NN>	Len=2
Safrananbau	Safran<NN>Anbau<NN>	Len=2
Eichenhain	Eiche<NN>Hain<NN>	Len=2
Fluchtimpuls	Flucht<NN>Impuls<NN>	Len=2
Hirseanbau	Hirse<NN>Anbau<NN>	Len=2
Leimschicht	Leim<NN>Schicht<NN>	Len=2
Sommerkatalog	Sommer<NN>Katalog<NN>	Len=2
Behandlungzyklus	Behandlung<NN>Zyklus<NN>	Len=2
Zugantrieb	Zug<NN>Antrieb<NN>	Len=2
Urlaubsaffäre	Urlaub<NN>Affäre<NN>	Len=2
Blumenmädchen	Blume<NN>Mädchen<NN>	Len=2
Pausenmusik	Pause<NN>Musik<NN>	Len=2
Komödienklassiker	Komödie<NN>Klassiker<NN>	Len=2
Trennungsirrsinn	Trennung<NN>Irrsinn<NN>	Len=2
Schleimproduktion	Schleim<NN>Produktion<NN>	Len=2
Pflanzenextrakt	Pflanze<NN>Extrakt<NN>	Len=2
Traumvertrag	Traum<NN>Vertrag<NN>	Len=2
Wüstenterrain	Wüste<NN>Terrain<NN>	Len=2
Männerrock	Mann<NN>Rock<NN>	Len=2
Sesameis	Sesam<NN>Eis<NN>	Len=2
