Uranmine	Uran<NN>Mine<NN>
Polizeizeitung	Polizei<NN>Zeitung<NN>
Ölporträt	Öl<NN>Porträt<NN>
Apfelduft	Apfel<NN>Duft<NN>
Explosionswolke	Explosion<NN>Wolke<NN>
Erdlawine	Erde<NN>Lawine<NN>
Silvesterkrach	Silvester<NN>Krach<NN>
Mopsdame	Mops<NN>Dame<NN>
Abschiedsinterview	Abschied<NN>Interview<NN>
Badumbau	Bad<NN>Umbau<NN>
Bronzeschmuck	Bronze<NN>Schmuck<NN>
Satirezeitung	Satire<NN>Zeitung<NN>
Sonntagsverkehr	Sonntag<NN>Verkehr<NN>
Imagewechsel	Image<NN>Wechsel<NN>
Politikergeschwätz	Politiker<NN>Geschwätz<NN>
Fassadenglas	Fassade<NN>Glas<NN>
Pizzateller	Pizza<NN>Teller<NN>
Unfallbereich	Unfall<NN>Bereich<NN>
Rentierfamilie	Rentier<NN>Familie<NN>
Sonnenvitamin	Sonne<NN>Vitamin<NN>
Pferderomantik	Pferd<NN>Romantik<NN>
Strandsport	Strand<NN>Sport<NN>
Klinikumsgelände	Klinikum<NN>Gelände<NN>
Eignungsprofil	Eignung<NN>Profil<NN>
Ausbildungsphase	Ausbildung<NN>Phase<NN>
Karabinerhaken	Karabiner<NN>Haken<NN>
Leinenwurf	Leinen<NN>Wurf<NN>
Serienkonsum	Serie<NN>Konsum<NN>
Opferstatus	Opfer<NN>Status<NN>
Käsesandwich	Käse<NN>Sandwich<NN>
Filmgelände	Film<NN>Gelände<NN>
Safrananbau	Safran<NN>Anbau<NN>
Eichenhain	Eiche<NN>Hain<NN>
Fluchtimpuls	Flucht<NN>Impuls<NN>
Hirseanbau	Hirse<NN>Anbau<NN>
Leimschicht	Leim<NN>Schicht<NN>
Sommerkatalog	Sommer<NN>Katalog<NN>
Behandlungzyklus	Behandlung<NN>Zyklus<NN>
Zugantrieb	Zug<NN>Antrieb<NN>
Urlaubsaffäre	Urlaub<NN>Affäre<NN>
Blumenmädchen	Blume<NN>Mädchen<NN>
Pausenmusik	Pause<NN>Musik<NN>
Komödienklassiker	Komödie<NN>Klassiker<NN>
Trennungsirrsinn	Trennung<NN>Irrsinn<NN>
Schleimproduktion	Schleim<NN>Produktion<NN>
Pflanzenextrakt	Pflanze<NN>Extrakt<NN>
Traumvertrag	Traum<NN>Vertrag<NN>
Wüstenterrain	Wüste<NN>Terrain<NN>
Männerrock	Mann<NN>Rock<NN>
Sesameis	Sesam<NN>Eis<NN>
Nagellack	Nagel<NN>Lack<NN>
Parkettreihe	Parkett<NN>Reihe<NN>
Quotenverlust	Quote<NN>Verlust<NN>
Fischpackung	Fisch<NN>Packung<NN>
Buchstabenfolge	Buchstabe<NN>Folge<NN>
Monatsmiete	Monat<NN>Miete<NN>
Mathematikprofessor	Mathematik<NN>Professor<NN>
Kulturplakat	Kultur<NN>Plakat<NN>
Zitronenschale	Zitrone<NN>Schale<NN>
Wartschleife	Wart<NN>Schleife<NN>
Pinselvirtuose	Pinsel<NN>Virtuose<NN>
Währungsystem	Währung<NN>System<NN>
Bergoutfit	Berg<NN>Outfit<NN>
Umweltstrategie	Umwelt<NN>Strategie<NN>
Abgastest	Abgas<NN>Test<NN>
Durchgangsort	Durchgang<NN>Ort<NN>
Einstellungstopp	Einstellung<NN>Stopp<NN>
Antiquitätenhändler	Antiquität<NN>Händler<NN>
Durchschnittsfamilie	Durchschnitt<NN>Familie<NN>
Bäckereigehilfe	Bäckerei<NN>Gehilfe<NN>
Krisenschlichtung	Krise<NN>Schlichtung<NN>
Schreckenszenario	Schrecken<NN>Szenario<NN>
Karosseriespezialist	Karosserie<NN>Spezialist<NN>
Nudeltopf	Nudel<NN>Topf<NN>
Technologiemanagement	Technologie<NN>Management<NN>
Jugendstilvilla	Jugendstil<NN>Villa<NN>
Preisverantwortung	Preis<NN>Verantwortung<NN>
Terrorkämpfer	Terror<NN>Kämpfer<NN>
Rotationspunkt	Rotation<NN>Punkt<NN>
Rollenvergabe	Rolle<NN>Vergabe<NN>
Profitvorgabe	Profit<NN>Vorgabe<NN>
Abwasserleitung	Abwasser<NN>Leitung<NN>
Antrittsrede	Antritt<NN>Rede<NN>
Inspektionsabteilung	Inspektion<NN>Abteilung<NN>
Lizenztausch	Lizenz<NN>Tausch<NN>
Turbinenumdrehung	Turbine<NN>Umdrehung<NN>
Bundestagsopposition	Bundestag<NN>Opposition<NN>
Hochwasservorhersage	Hochwasser<NN>Vorhersage<NN>
Spinatknödel	Spinat<NN>Knödel<NN>
Riesenpumpe	Riese<NN>Pumpe<NN>
Produktionsregie	Produktion<NN>Regie<NN>
Markensystem	Marke<NN>System<NN>
Stuckdecke	Stuck<NN>Decke<NN>
Flankentor	Flanke<NN>Tor<NN>
Familienhistorie	Familie<NN>Historie<NN>
Architekturbetrieb	Architektur<NN>Betrieb<NN>
Rosinenhändler	Rosine<NN>Händler<NN>
Satellitenkommunikation	Satellit<NN>Kommunikation<NN>
Papiergröße	Papier<NN>Größe<NN>
Plastikröhre	Plastik<NN>Röhre<NN>
Olympiapool	Olympia<NN>Pool<NN>
Autourlauber	Auto<NN>Urlauber<NN>
Armutsquote	Armut<NN>Quote<NN>
Parteihistorie	Partei<NN>Historie<NN>
Konzernstatistik	Konzern<NN>Statistik<NN>
Museumsarchitektur	Museum<NN>Architektur<NN>
Transportmenge	Transport<NN>Menge<NN>
Schulgutachter	Schule<NN>Gutachter<NN>
Erfolgszeichen	Erfolg<NN>Zeichen<NN>
Tramdepot	Tram<NN>Depot<NN>
Dürrekatastrophe	Dürre<NN>Katastrophe<NN>
Balladenalbum	Ballade<NN>Album<NN>
Buchillustrator	Buch<NN>Illustrator<NN>
Eibenbestand	Eibe<NN>Bestand<NN>
Elchgeweih	Elch<NN>Geweih<NN>
Schablonenbild	Schablone<NN>Bild<NN>
Bildschirmnavigation	Bildschirm<NN>Navigation<NN>
Flächenfraß	Fläche<NN>Fraß<NN>
Schreibmaschinenmechaniker	Schreibmaschine<NN>Mechaniker<NN>
Igelpopulation	Igel<NN>Population<NN>
Problempriester	Problem<NN>Priester<NN>
Fußballdelegation	Fußball<NN>Delegation<NN>
Renteneintritt	Rente<NN>Eintritt<NN>
Profifotograf	Profi<NN>Fotograf<NN>
Kohlenstaub	Kohle<NN>Staub<NN>
Hoffnungsperspektive	Hoffnung<NN>Perspektive<NN>
Skiparadies	Ski<NN>Paradies<NN>
Verlegerbranche	Verleger<NN>Branche<NN>
Zahlentastatur	Zahl<NN>Tastatur<NN>
Elitenprojekt	Elite<NN>Projekt<NN>
Scheitelfrisur	Scheitel<NN>Frisur<NN>
Simulationsära	Simulation<NN>Ära<NN>
Konteninhaber	Konto<NN>Inhaber<NN>
Nahrungspflanze	Nahrung<NN>Pflanze<NN>
Garteninstallation	Garten<NN>Installation<NN>
Barrikadetaktik	Barrikade<NN>Taktik<NN>
Obstauslage	Obst<NN>Auslage<NN>
Zinngeschirr	Zinn<NN>Geschirr<NN>
Gutachterbranche	Gutachter<NN>Branche<NN>
Bromschwaden	Brom<NN>Schwaden<NN>
Sportmesse	Sport<NN>Messe<NN>
Filmkomponist	Film<NN>Komponist<NN>
Geschmackssimulator	Geschmack<NN>Simulator<NN>
Plagiatssoftware	Plagiat<NN>Software<NN>
Institutsniederlassung	Institut<NN>Niederlassung<NN>
Studentenkonzept	Student<NN>Konzept<NN>
Serienschauspieler	Serie<NN>Schauspieler<NN>
Appartementkomplex	Appartement<NN>Komplex<NN>
Verleihvolumen	Verleih<NN>Volumen<NN>
Parteienrecht	Partei<NN>Recht<NN>
Kommunikationsstudent	Kommunikation<NN>Student<NN>
Hafengebühr	Hafen<NN>Gebühr<NN>
Liniengeflecht	Linie<NN>Geflecht<NN>
Punkteverzeichnis	Punkt<NN>Verzeichnis<NN>
Rentengesetz	Rente<NN>Gesetz<NN>
Qualitätspresse	Qualität<NN>Presse<NN>
Bundesligazirkus	Bundesliga<NN>Zirkus<NN>
Fruchthändler	Frucht<NN>Händler<NN>
Beitragseinnahme	Beitrag<NN>Einnahme<NN>
Republikanerbasis	Republikaner<NN>Basis<NN>
Anzugschneider	Anzug<NN>Schneider<NN>
Vorverkaufstermin	Vorverkauf<NN>Termin<NN>
Sommerurlauber	Sommer<NN>Urlauber<NN>
Grundirrtum	Grund<NN>Irrtum<NN>
Preisköder	Preis<NN>Köder<NN>
Kostümwechsel	Kostüm<NN>Wechsel<NN>
Partikelfilter	Partikel<NN>Filter<NN>
Autotür	Auto<NN>Türe<NN>
Rohstoffkrise	Rohstoff<NN>Krise<NN>
Raumfahrthistoriker	Raumfahrt<NN>Historiker<NN>
Feuerwehrabzeichen	Feuerwehr<NN>Abzeichen<NN>
Sanitätsfahrzeug	Sanität<NN>Fahrzeug<NN>
Traumaambulanz	Trauma<NN>Ambulanz<NN>
Bühnenauftritt	Bühne<NN>Auftritt<NN>
Traditionsgaststätte	Tradition<NN>Gaststätte<NN>
Solistenchor	Solist<NN>Chor<NN>
Naturpädagogik	Natur<NN>Pädagogik<NN>
Wachstumkurs	Wachstum<NN>Kurs<NN>
Ghettomusiker	Ghetto<NN>Musiker<NN>
Mannschaftsremis	Mannschaft<NN>Remis<NN>
Glücksziffer	Glück<NN>Ziffer<NN>
Hühnervolk	Huhn<NN>Volk<NN>
Stiellänge	Stiel<NN>Länge<NN>
Farbtreue	Farbe<NN>Treue<NN>
Ressourcenstrategie	Ressource<NN>Strategie<NN>
Schaffensdrang	Schaffen<NN>Drang<NN>
Konzernmanager	Konzern<NN>Manager<NN>
Mangelregion	Mangel<NN>Region<NN>
Brandschreiben	Brand<NN>Schreiben<NN>
Devisenbedarf	Devise<NN>Bedarf<NN>
Modepatzer	Mode<NN>Patzer<NN>
Küstenstrecke	Küste<NN>Strecke<NN>
Nachfolgegesellschaft	Nachfolge<NN>Gesellschaft<NN>
Anlagenumfeld	Anlage<NN>Umfeld<NN>
Lebenslaufkosmetik	Lebenslauf<NN>Kosmetik<NN>
Anlaufgeschwindigkeit	Anlauf<NN>Geschwindigkeit<NN>
Hundekäfig	Hund<NN>Käfig<NN>
Toasterschalter	Toaster<NN>Schalter<NN>
Bildungsbüro	Bildung<NN>Büro<NN>
Gemeindepolitesse	Gemeinde<NN>Politesse<NN>
Nischenevent	Nische<NN>Event<NN>
Schülerprotest	Schüler<NN>Protest<NN>
Metalltafel	Metall<NN>Tafel<NN>
Stundenanzeige	Stunde<NN>Anzeige<NN>
Sicherheitsnachweis	Sicherheit<NN>Nachweis<NN>
Brudermord	Bruder<NN>Mord<NN>
Luxushafen	Luxus<NN>Hafen<NN>
Algenmorast	Alge<NN>Morast<NN>
Terrarienkunde	Terrarium<NN>Kunde<NN>
Bronzepokal	Bronze<NN>Pokal<NN>
Einwohnerpauschale	Einwohner<NN>Pauschale<NN>
Auftragskoordinator	Auftrag<NN>Koordinator<NN>
Schlafumgebung	Schlaf<NN>Umgebung<NN>
Preisdurchschnitt	Preis<NN>Durchschnitt<NN>
Brunnenkönigin	Brunnen<NN>Königin<NN>
Radonbelastung	Radon<NN>Belastung<NN>
Gemeindeidentität	Gemeinde<NN>Identität<NN>
Anwohnerschutz	Anwohner<NN>Schutz<NN>
Museumsdach	Museum<NN>Dach<NN>
Turnierklassiker	Turnier<NN>Klassiker<NN>
Thekenbereich	Theke<NN>Bereich<NN>
Projektkultur	Projekt<NN>Kultur<NN>
Pensionsverzicht	Pension<NN>Verzicht<NN>
Mediengetöse	Medium<NN>Getöse<NN>
Geiselkonflikt	Geisel<NN>Konflikt<NN>
Proteinmangel	Protein<NN>Mangel<NN>
Galarobe	Gala<NN>Robe<NN>
Adipositasbehandlung	Adipositas<NN>Behandlung<NN>
Bootslack	Boot<NN>Lack<NN>
Frachtaufkommen	Fracht<NN>Aufkommen<NN>
Geschäftskollege	Geschäft<NN>Kollege<NN>
Imagearbeit	Image<NN>Arbeit<NN>
Spekulatiusmarkt	Spekulatius<NN>Markt<NN>
Kostümfilm	Kostüm<NN>Film<NN>
Wasserspezialist	Wasser<NN>Spezialist<NN>
Fohlengeburt	Fohlen<NN>Geburt<NN>
Sporttherapeut	Sport<NN>Therapeut<NN>
Kalenderverlag	Kalender<NN>Verlag<NN>
Zucchinibeet	Zucchini<NN>Beet<NN>
Fahrradbremse	Fahrrad<NN>Bremse<NN>
Meisterschaftsmedaille	Meisterschaft<NN>Medaille<NN>
Bundesligatabelle	Bundesliga<NN>Tabelle<NN>
Literaturmesse	Literatur<NN>Messe<NN>
Bernsteinkette	Bernstein<NN>Kette<NN>
Muskelrückgang	Muskel<NN>Rückgang<NN>
Diplomatenausweis	Diplomat<NN>Ausweis<NN>
Protestkarawane	Protest<NN>Karawane<NN>
Kaffeevariation	Kaffee<NN>Variation<NN>
Cartoonistengruppe	Cartoonist<NN>Gruppe<NN>
Namensstreit	Name<NN>Streit<NN>
Haushaltausgleich	Haushalt<NN>Ausgleich<NN>
Zisterzienserkloster	Zisterzienser<NN>Kloster<NN>
Karaokebar	Karaoke<NN>Bar<NN>
Bootsbaustelle	Boot<NN>Baustelle<NN>
Abfallkonzept	Abfall<NN>Konzept<NN>
Stromspeicherung	Strom<NN>Speicherung<NN>
Netztechnologie	Netz<NN>Technologie<NN>
Orchestergraben	Orchester<NN>Graben<NN>
Siliziumherz	Silizium<NN>Herz<NN>
Aktienbarometer	Aktie<NN>Barometer<NN>
Suppenkonsistenz	Suppe<NN>Konsistenz<NN>
Synthesegas	Synthese<NN>Gas<NN>
Prachtfassade	Pracht<NN>Fassade<NN>
Debattengelegenheit	Debatte<NN>Gelegenheit<NN>
Lagerhierarchie	Lager<NN>Hierarchie<NN>
Gerüchtestrudel	Gerücht<NN>Strudel<NN>
Schauspielerverband	Schauspieler<NN>Verband<NN>
Pensionspapier	Pension<NN>Papier<NN>
Saisonticket	Saison<NN>Ticket<NN>
Spannungspotential	Spannung<NN>Potential<NN>
Panzertraining	Panzer<NN>Training<NN>
Fruchtbarkeitsmedizin	Fruchtbarkeit<NN>Medizin<NN>
Verkehraufkommen	Verkehr<NN>Aufkommen<NN>
Marktökonomie	Markt<NN>Ökonomie<NN>
Satellitenmission	Satellit<NN>Mission<NN>
Küchenboden	Küche<NN>Boden<NN>
Prismenglas	Prisma<NN>Glas<NN>
Modekarriere	Mode<NN>Karriere<NN>
Museumsaula	Museum<NN>Aula<NN>
Hochzeitsdinner	Hochzeit<NN>Dinner<NN>
Antilopenbock	Antilope<NN>Bock<NN>
Finanzkauderwelsch	Finanz<NN>Kauderwelsch<NN>
Bankerhimmel	Banker<NN>Himmel<NN>
Speicherfunktion	Speicher<NN>Funktion<NN>
Pressedossier	Presse<NN>Dossier<NN>
Wertungssystem	Wertung<NN>System<NN>
Comicbranche	Comic<NN>Branche<NN>
Ausstellungsboykott	Ausstellung<NN>Boykott<NN>
Teilnehmerschein	Teilnehmer<NN>Schein<NN>
Batterienhersteller	Batterie<NN>Hersteller<NN>
Gastronomieangebot	Gastronomie<NN>Angebot<NN>
Provinzdepp	Provinz<NN>Depp<NN>
Sicherheitsvorschrift	Sicherheit<NN>Vorschrift<NN>
Kabarettszene	Kabarett<NN>Szene<NN>
Klebstoffaroma	Klebstoff<NN>Aroma<NN>
Ameisenverkehr	Ameise<NN>Verkehr<NN>
Benzinpartikel	Benzin<NN>Partikel<NN>
Dachgewölbe	Dach<NN>Gewölbe<NN>
Tugendwächter	Tugend<NN>Wächter<NN>
Oktobervormittag	Oktober<NN>Vormittag<NN>
