erziehen ung er	Erziehungsmaßnahme erziehen<V>ung<SUFF><NN>Maßnahme	Horterzieher Hort<NN>erziehen<V>er<SUFF>
verweigern ung er	Erfahrungsverweigerung Erfahrung<NN>verweigern<V>ung<SUFF>	Leistungsverweigerer Leistung<NN>verweigern<V>er<SUFF>
erzeugen ung er	Lackerzeugung Lack<NN>erzeugen<V>ung<SUFF>	Gitarrenerzeuger Gitarre<NN>erzeugen<V>er<SUFF>
versorgen ung er	Politikerversorgung Politiker<NN>versorgen<V>ung<SUFF>	Endversorger Ende<NN>versorgen<V>er<SUFF>
vernetzen ung er	Vernetzungsprojekt vernetzen<V>ung<SUFF><NN>Projekt	Vernetzerin vernetzen<V>er<SUFF><NN>in<SUFF>
erhöhen ung er	Nachfrageerhöhung Nachfrage<NN>erhöhen<V>ung<SUFF>	Steuererhöher Steuer<NN>erhöhen<V>er<SUFF>
beschaffen ung er	Beschaffungsaufwand beschaffen<V>ung<SUFF><NN>Aufwand	Informationsbeschaffer Information<NN>beschaffen<V>er<SUFF>
bewältigen ung er	Schicksalsbewältigung Schicksal<NN>bewältigen<V>ung<SUFF>	Aufgabenbewältiger Aufgabe<NN>bewältigen<V>er<SUFF>
verarbeiten ung er	Wahrnehmungsverarbeitung Wahrnehmung<NN>verarbeiten<V>ung<SUFF>	Obstverarbeiter Obst<NN>verarbeiten<V>er<SUFF>
verschärfen ung er	Sanktionsverschärfung Sanktion<NN>verschärfen<V>ung<SUFF>	Krisenverschärfer Krise<NN>verschärfen<V>er<SUFF>
machen ung bar	Dauerverächtlichmachung Dauer<NN>verächtlich<ADJ>machen<V>ung<SUFF>	Machbarkeitsvariante machen<V>bar<ADJ><SUFF>keit<SUFF><NN>Variante
machen er ung	Zeitschriftenmacher Zeitschrift<NN>machen<V>er<SUFF>	Dauerverächtlichmachung Dauer<NN>verächtlich<ADJ>machen<V>ung<SUFF>
verhandeln ung er	Verhandlungsstrategie verhandeln<V>ung<SUFF><NN>Strategie	Regierungsverhandler Regierung<NN>verhandeln<V>er<SUFF>
verschulden ung er	Unmutsverschuldung Unmut<NN>verschulden<V>ung<SUFF>	Gegentorverschulder gegen<PREF>Tor<NN>verschulden<V>er<SUFF>
verehren er ung	Hirnverehrer Hirn<NN>verehren<V>er<SUFF>	Lichterverehrung Licht<NN>verehren<V>ung<SUFF>
verstärken er ung	Meinungsverstärker Meinung<NN>verstärken<V>er<SUFF>	Sitzplatzverstärkung Sitzplatz<NN>verstärken<V>ung<SUFF>
beglücken ung er	Staatsbeglückungsroutine Staat<NN>beglücken<V>ung<SUFF><NN>Routine	Kinderbeglücker Kind<NN>beglücken<V>er<SUFF>
verbessern ung er	Verbesserungsgebot verbessern<V>ung<SUFF><NN>Gebot	Schulverbesserer Schule<NN>verbessern<V>er<SUFF>
stabilisieren ung er	Finanzmarktstabilisierungsgesetz Finanz<NN>Markt<NN>stabilisieren<V>ung<SUFF><NN>Gesetz	Kursstabilisierer Kurs<NN>stabilisieren<V>er<SUFF>
überziehen er ung	Plastiküberzieher Plastik<NN>überziehen<V>er<SUFF>	Überziehungszeit überziehen<V>ung<SUFF><NN>Zeit
verwahren ung er	Datenverwahrung Datum<NN>verwahren<V>ung<SUFF>	Geschichtsverwahrer Geschichte<NN>verwahren<V>er<SUFF>
entführen er ung	Entführerpaar entführen<V>er<SUFF><NN>Paar	Entführungsplan entführen<V>ung<SUFF><NN>Plan
erhalten er ung	Familienerhalter Familie<NN>erhalten<V>er<SUFF>	Erhaltungsbetrieb erhalten<V>ung<SUFF><NN>Betrieb
entfernen ung er	Entfernungsunterschied entfernen<V>ung<SUFF><NN>Unterschied	Fleckenentferner Flecken<NN>entfernen<V>er<SUFF>
verfilmen er ung	Literaturverfilmer Literatur<NN>verfilmen<V>er<SUFF>	Superheldenverfilmung super<PREF>Held<NN>verfilmen<V>ung<SUFF>
gerinnen ung er	Gerinnungshemmer gerinnen<V>ung<SUFF><NN>hemmen<V>er<SUFF>	Blutgerinner Blut<NN>gerinnen<V>er<SUFF>
gerinnen er bar	Blutgerinner Blut<NN>gerinnen<V>er<SUFF>	Blutgerinnbarkeit Blut<NN>gerinnen<V>bar<ADJ><SUFF>keit<SUFF>
scannen er ung	Scannertyp scannen<V>er<SUFF><NN>Typ	Schachtscannung Schacht<NN>scannen<V>ung<SUFF>
beraten ung er	Neukundenberatung neu<ADJ>Kunde<NN>beraten<V>ung<SUFF>	Berufsberaterin Beruf<NN>beraten<V>er<SUFF><NN>in<SUFF>
bestatten ung er	Bestattungsmethode bestatten<V>ung<SUFF><NN>Methode	Stadtbestatter Stadt<NN>bestatten<V>er<SUFF>
überlassen ung er	Rechteüberlassung Recht<NN>überlassen<V>ung<SUFF>	Arbeitskräfteüberlasser Arbeit<NN>Kraft<NN>überlassen<V>er<SUFF>
erweitern ung er	Hafenerweiterung Hafen<NN>erweitern<V>ung<SUFF>	Bronchienerweiterer Bronchie<NN>erweitern<V>er<SUFF>
überwachen ung er	Überwachungsparadies überwachen<V>ung<SUFF><NN>Paradies	Luftraumüberwacher Luft<NN>Raum<NN>überwachen<V>er<SUFF>
spenden er ung	Nektarspender Nektar<NN>spenden<V>er<SUFF>	Segensspendung Segen<NN>spenden<V>ung<SUFF>
graben ung er	Grabungsfund graben<V>ung<SUFF><NN>Fund	Scheibengraber Scheibe<NN>graben<V>er<SUFF>
entwickeln ung er	Führungsentwicklung Führung<NN>entwickeln<V>ung<SUFF>	Autoentwickler Auto<NN>entwickeln<V>er<SUFF>
veranstalten ung er	Veranstaltungsseite veranstalten<V>ung<SUFF><NN>Seite	Veranstalterseite veranstalten<V>er<SUFF><NN>Seite
verwalten ung er	Substanzverwaltung Substanz<NN>verwalten<V>ung<SUFF>	Gutsverwalter Gut<NN>verwalten<V>er<SUFF>
fassen ung er	Stückfassung Stück<NN>fassen<V>ung<SUFF>	Vorsatzfasser Vorsatz<NN>fassen<V>er<SUFF>
mischen ung er	Kadermischung Kader<NN>mischen<V>ung<SUFF>	Parfümmischer Parfüm<NN>mischen<V>er<SUFF>
erstatten ung er	Teilerstattung Teil<NN>erstatten<V>ung<SUFF>	Parlamentsberichterstatterin Parlament<NN>Bericht<NN>erstatten<V>er<SUFF><NN>in<SUFF>
reinigen ung er	Klärgrubenreinigung klären<V>Grube<NN>reinigen<V>ung<SUFF>	Fleckenreiniger Flecken<NN>reinigen<V>er<SUFF>
verteilen ung er	Verteilungsspielraum verteilen<V>ung<SUFF><NN>Spielraum	Verteilerverkehr verteilen<V>er<SUFF><NN>Verkehr
erpressen ung er	Kopfgelderpressung Kopf<NN>Geld<NN>erpressen<V>ung<SUFF>	Erpresserbande erpressen<V>er<SUFF><NN>Bande
begrüßen ung er	Begrüßungsschnaps begrüßen<V>ung<SUFF><NN>Schnaps	Einheitsbegrüßer Einheit<NN>begrüßen<V>er<SUFF>
untersuchen ung er	Untersuchungskommission untersuchen<V>ung<SUFF><NN>Kommission	Unfalluntersucher Unfall<NN>untersuchen<V>er<SUFF>
vernichten ung er	Vernichtungsprogramm vernichten<V>ung<SUFF><NN>Programm	Materialvernichterin Material<NN>vernichten<V>er<SUFF><NN>in<SUFF>
beleuchten ung er	Silvesterbeleuchtung Silvester<NN>beleuchten<V>ung<SUFF>	Hintergrundbeleuchter Hintergrund<NN>beleuchten<V>er<SUFF>
fälschen er ung	Serienfälscher Serie<NN>fälschen<V>er<SUFF>	Hochglanzfälschung Hochglanz<NN>fälschen<V>ung<SUFF>
bearbeiten ung er	Feldbearbeitung Feld<NN>bearbeiten<V>ung<SUFF>	Sachbearbeiterteam Sache<NN>bearbeiten<V>er<SUFF><NN>Team
befreien ung er	Befreiungsschlag befreien<V>ung<SUFF><NN>Schlag	Feldbefreier Feld<NN>befreien<V>er<SUFF>
bieten er ung	Bietergefecht bieten<V>er<SUFF><NN>Gefecht	Ehrbietung Ehre<NN>bieten<V>ung<SUFF>
versöhnen ung er	Versöhnungsschnulze versöhnen<V>ung<SUFF><NN>Schnulze	Chefversöhner Chef<NN>versöhnen<V>er<SUFF>
erkennen ung er	Erkennungsrate erkennen<V>ung<SUFF><NN>Rate	Spracherkenner Sprache<NN>erkennen<V>er<SUFF>
fertigen ung er	Fertigungspartner fertigen<V>ung<SUFF><NN>Partner	Schuhfertigerin Schuh<NN>fertigen<V>er<SUFF><NN>in<SUFF>
vernehmen ung er	Vernehmungsbeamte vernehmen<V>ung<SUFF><NN>Beamte	Vernehmertrakt vernehmen<V>er<SUFF><NN>Trakt
beruhigen ung er	Beruhigungsappell beruhigen<V>ung<SUFF><NN>Appell	Spielberuhiger Spiel<NN>beruhigen<V>er<SUFF>
ermitteln ung er	Ermittlungsstelle ermitteln<V>ung<SUFF><NN>Stelle	Ermittlerarbeit ermitteln<V>er<SUFF><NN>Arbeit
verfügen bar ung	Allverfügbarkeit All<NN>verfügen<V>bar<ADJ><SUFF>keit<SUFF>	Verfügungsverbot verfügen<V>ung<SUFF><NN>Verbot
finanzieren ung er	Zuschussfinanzierung Zuschuss<NN>finanzieren<V>ung<SUFF>	Häuslefinanzierer Häusle<NN>finanzieren<V>er<SUFF>
übertragen ung er	Mindestübertragungsrate mindest<ADJ>übertragen<V>ung<SUFF><NN>Rate	Überträgerstatus übertragen<V>er<SUFF><NN>Status
verteidigen ung er	Verteidigungsrecht verteidigen<V>ung<SUFF><NN>Recht	Stammlinksverteidiger Stamm<NN>Link<NN>verteidigen<V>er<SUFF>
entscheiden ung er	Kompensationsentscheidung Kompensation<NN>entscheiden<V>ung<SUFF>	Blitzentscheider Blitz<NN>entscheiden<V>er<SUFF>
beleidigen ung er	Zuschauerbeleidigung Zuschauer<NN>beleidigen<V>ung<SUFF>	Prophetenbeleidiger Prophet<NN>beleidigen<V>er<SUFF>
beschichten ung er	Wandbeschichtung Wand<NN>beschichten<V>ung<SUFF>	Oberflächenbeschichter Oberfläche<NN>beschichten<V>er<SUFF>
befördern ung er	Fahrgastbeförderung Fahrgast<NN>befördern<V>ung<SUFF>	Güterbeförderer Gut<NN>befördern<V>er<SUFF>
verkosten ung er	Likörverkostung Likör<NN>verkosten<V>ung<SUFF>	Frauenverkoster Frau<NN>verkosten<V>er<SUFF>
beschreiben ung er	Gefühlsbeschreibung Gefühl<NN>beschreiben<V>ung<SUFF>	Lebensbeschreiberin Leben<NN>beschreiben<V>er<SUFF><NN>in<SUFF>
beobachten ung er	Beobachtungsflugzeug beobachten<V>ung<SUFF><NN>Flugzeug	Parteibeobachter Partei<NN>beobachten<V>er<SUFF>
beobachten er bar	Parteibeobachter Partei<NN>beobachten<V>er<SUFF>	Beobachtbarkeitsdilemma beobachten<V>bar<ADJ><SUFF>keit<SUFF><NN>Dilemma
schätzen ung er	Markenwertschätzung Marke<NN>Wert<NN>schätzen<V>ung<SUFF>	Staatsschätzer Staat<NN>schätzen<V>er<SUFF>
verschwören ung er	Verschwörungsmist verschwören<V>ung<SUFF><NN>Mist	Naziverschwörer Nazi<NN>verschwören<V>er<SUFF>
benutzen er ung	Benutzererlebnis benutzen<V>er<SUFF><NN>Erlebnis	Haftmittelbenutzung Haft<NN>mittel<ADJ>benutzen<V>ung<SUFF>
bewerben er ung	Bewerberseite bewerben<V>er<SUFF><NN>Seite	Bewerbungstitel bewerben<V>ung<SUFF><NN>Titel
verschieben ung er	Kontextverschiebung Kontext<NN>verschieben<V>ung<SUFF>	Spieleverschieber Spiel<NN>verschieben<V>er<SUFF>
denken er ung	Denkerplattform denken<V>er<SUFF><NN>Plattform	Denkungsart denken<V>ung<SUFF><NN>Art
ändern ung er	Regieänderung Regie<NN>ändern<V>ung<SUFF>	Mentalitätsänderer Mentalität<NN>ändern<V>er<SUFF>
stürmen ung er	Botschaftsstürmung Botschaft<NN>stürmen<V>ung<SUFF>	Keilstürmer Keil<NN>stürmen<V>er<SUFF>
verbinden ung er	Verbindungstüre verbinden<V>ung<SUFF><NN>Türe	Zellverbinder Zelle<NN>verbinden<V>er<SUFF>
unterdrücken er ung	Unterdrückerregime unterdrücken<V>er<NN><SUFF>Regime	Geräuschunterdrückungssystem Geräusch<NN>unterdrücken<V>ung<SUFF><NN>System
befürworten er ung	Existenzgeldbefürworter Existenz<NN>Geld<NN>befürworten<V>er<SUFF>	Kriegsbefürwortung Krieg<NN>befürworten<V>ung<SUFF>
versteigern ung er	Anleihenversteigerung Anleihe<NN>versteigern<V>ung<SUFF>	Kunstversteigerer Kunst<NN>versteigern<V>er<SUFF>
bewerten er ung	Markenbewerter Marke<NN>bewerten<V>er<SUFF>	Bewertungsgremium bewerten<V>ung<SUFF><NN>Gremium
erstellen ung er	Konzepterstellungsprozess Konzept<NN>erstellen<V>ung<SUFF><NN>Prozess	Zeugnisersteller Zeugnis<NN>erstellen<V>er<SUFF>
regulieren ung er	Regulierungsanspruch regulieren<V>ung<SUFF><NN>Anspruch	Regulierergruppe regulieren<V>er<SUFF><NN>Gruppe
programmieren er ung	Computerprogrammierer Computer<NN>programmieren<V>er<SUFF>	Kampfprogrammierung Kampf<NN>programmieren<V>ung<SUFF>
vermarkten ung er	Vermarktungsorganisation vermarkten<V>ung<SUFF><NN>Organisation	Vermarkteragentur vermarkten<V>er<SUFF><NN>Agentur
entlüften ung er	Entlüftungssteuerung entlüften<V>ung<SUFF><NN>Steuerung	Reizdarmentlüfter Reiz<NN>Darm<NN>entlüften<V>er<SUFF>
verzögern ung er	Verzögerungspolitik verzögern<V>ung<SUFF><NN>Politik	Schallverzögerer Schall<NN>verzögern<V>er<SUFF>
vermieten er ung	Liegenvermieter liegen<V><SUFF><NN>vermieten<V>er<SUFF>	Privatzimmervermietung privat<ADJ>Zimmer<NN>vermieten<V>ung<SUFF>
nutzen er bar	Nutzercommunity nutzen<V>er<SUFF><NN>Community	Nutzbarkeitsdauer nutzen<V>bar<ADJ><SUFF>keit<SUFF><NN>Dauer
nutzen ung bar	Baunutzungsverordnung bauen<V><SUFF><NN>nutzen<V>ung<SUFF><NN>verordnen<V>ung<SUFF>	Nutzbarkeitsdauer nutzen<V>bar<ADJ><SUFF>keit<SUFF><NN>Dauer
entsorgen ung er	Entsorgungsmanagement entsorgen<V>ung<SUFF><NN>Management	Entsorgertätigkeit entsorgen<V>er<SUFF><NN>Tätigkeit
besichtigen ung er	Drehortbesichtigung drehen<V>Ort<NN>besichtigen<V>ung<SUFF>	Objektbesichtiger Objekt<NN>besichtigen<V>er<SUFF>
vermitteln ung er	Meldungsvermittlungssystem Meldung<NN>vermitteln<V>ung<SUFF><NN>System	Kanzleivermittler Kanzlei<NN>vermitteln<V>er<SUFF>
steigern ung er	Wohnwertsteigerung wohnen<V>Wert<NN>steigern<V>ung<SUFF>	Leistungssteigerer Leistung<NN>steigern<V>er<SUFF>
buchen ung er	Buchungssituation buchen<V>ung<SUFF><NN>Situation	Frühbuchertarif früh<ADJ>buchen<V>er<NN><SUFF>Tarif
vermeiden er ung	Steuervermeider Steuer<NN>vermeiden<V>er<SUFF>	Schmerzvermeidung Schmerz<NN>vermeiden<V>ung<SUFF>
zerstören ung er	Zerstörungsorgie zerstören<V>ung<SUFF><NN>Orgie	Naturzerstörer Natur<NN>zerstören<V>er<SUFF>
verletzen ung er	Regelverletzung Regel<NN>verletzen<V>ung<SUFF>	Urheberrechtsverletzer Urheber<NN>rechts<ADJ>verletzen<V>er<SUFF>
heilen ung er	Heilungschance heilen<V>ung<SUFF><NN>Chance	Asthmaheiler Asthma<NN>heilen<V>er<SUFF>
überprüfen ung er	Diagnosenüberprüfung Diagnose<NN>überprüfen<V>ung<SUFF>	Grenzüberprüfer Grenze<NN>überprüfen<V>er<SUFF>
erklären ung er	Namenserklärung Name<NN>erklären<V>ung<SUFF>	Politikerklärer Politik<NN>erklären<V>er<SUFF>
verhetzen ung er	Verhetzungsparagraf verhetzen<V>ung<SUFF><NN>Paragraf	Volksverhetzer Volk<NN>verhetzen<V>er<SUFF>
öffnen ung er	Fensteröffnung Fenster<NN>öffnen<V>ung<SUFF>	Dosenöffnerprinzip Dose<NN>öffnen<V>er<NN><SUFF>Prinzip
eröffnen ung er	Eröffnungstarif eröffnen<V>ung<SUFF><NN>Tarif	Spieleröffner Spiel<NN>eröffnen<V>er<SUFF>
gefährden ung er	Gefährdungspotenzial gefährden<V>ung<SUFF><NN>Potenzial	Jugendgefährder Jugend<NN>gefährden<V>er<SUFF>
belüften ung er	Belüftungsanlage belüften<V>ung<SUFF><NN>Anlage	Druckbelüfter Druck<NN>belüften<V>er<SUFF>
reduzieren ung er	Schadensreduzierung Schaden<NN>reduzieren<V>ung<SUFF>	Spannungsreduzierer Spannung<NN>reduzieren<V>er<SUFF>
erwerben er ung	Erwerberkreis erwerben<V>er<SUFF><NN>Kreis	Erwerbungsgeschichte erwerben<V>ung<SUFF><NN>Geschichte
geben er ung	Ehrenwortgeber ehren<V><SUFF><NN>Wort<NN>geben<V>er<SUFF>	Fusionsbildgebung Fusion<NN>Bild<NN>geben<V>ung<SUFF>
erneuern ung er	Erneuerungskraft erneuern<V>ung<SUFF><NN>Kraft	Kinoerneuerer Kino<NN>erneuern<V>er<SUFF>
beherrschen ung er	Waffenbeherrschung Waffe<NN>beherrschen<V>ung<SUFF>	Milchstraßenbeherrscher Milch<NN>Straße<NN>beherrschen<V>er<SUFF>
berechnen ung er	Berechnungsverfahren berechnen<V>ung<SUFF><NN>Verfahren	Wirtschaftlichkeitsberechner wirtschaftlich<ADJ>keit<SUFF><NN>berechnen<V>er<SUFF>
erwärmen ung er	Erderwärmungsproblem Erde<NN>erwärmen<V>ung<SUFF><NN>Problem	Gemütserwärmer Gemüt<NN>erwärmen<V>er<SUFF>
verhindern ung er	Geburtenverhinderung Geburt<NN>verhindern<V>ung<SUFF>	Torverhinderer Tor<NN>verhindern<V>er<SUFF>
verbreiten ung er	Verbreitungsmöglichkeit verbreiten<V>ung<SUFF><NN>Möglichkeit	Wissensverbreiter Wissen<NN>verbreiten<V>er<SUFF>
quetschen ung er	Kehlkopfquetschung Kehlkopf<NN>quetschen<V>ung<SUFF>	Apfelquetschertag Apfel<NN>quetschen<V>er<SUFF><NN>Tag
ernähren ung er	Ernährungsgeschichte ernähren<V>ung<SUFF><NN>Geschichte	Welternährer Welt<NN>ernähren<V>er<SUFF>
projektieren ung er	Projektierungsfirma projektieren<V>ung<SUFF><NN>Firma	Windprojektierer Wind<NN>projektieren<V>er<SUFF>
befragen ung er	Haushaltsbefragung Haushalt<NN>befragen<V>ung<SUFF>	Zensusbefrager Zensus<NN>befragen<V>er<SUFF>
verteuern ung er	Projektverteuerung Projekt<NN>verteuern<V>ung<SUFF>	Preisverteuerer Preis<NN>verteuern<V>er<SUFF>
beeinflussen ung er	Kursbeeinflussung Kurs<NN>beeinflussen<V>ung<SUFF>	Beeinflussernetz beeinflussen<V>er<SUFF><NN>Netz
erzählen ung er	Icherzählung Ich<NN>erzählen<V>ung<SUFF>	Kinoerzähler Kino<NN>erzählen<V>er<SUFF>
versenken er ung	Schiffeversenker Schiff<NN>versenken<V>er<SUFF>	Bücherversenkung Buch<NN>versenken<V>ung<SUFF>
schärfen ung er	Bewusstseinsschärfung Bewusstsein<NN>schärfen<V>ung<SUFF>	Blitzschärfer Blitz<NN>schärfen<V>er<SUFF>
begleiten er ung	Erdbegleiter Erde<NN>begleiten<V>er<SUFF>	Reintegrationsbegleitung Reintegration<NN>begleiten<V>ung<SUFF>
beseitigen ung er	Kotbeseitigung Kot<NN>beseitigen<V>ung<SUFF>	Kampfmittelbeseitiger Kampf<NN>mittel<ADJ>beseitigen<V>er<SUFF>
vermessen ung er	Landvermessung Land<NN>vermessen<V>ung<SUFF>	Weltraumvermesser Weltraum<NN>vermessen<V>er<SUFF>
verstopfen ung er	Abflussverstopfung Abfluss<NN>verstopfen<V>ung<SUFF>	Netzverstopfer Netz<NN>verstopfen<V>er<SUFF>
beurteilen ung er	Beurteilungsprozess beurteilen<V>ung<SUFF><NN>Prozess	Kreditbeurteiler Kredit<NN>beurteilen<V>er<SUFF>
erobern er ung	Eroberertum erobern<V>er<SUFF><NN>tum<SUFF>	Balleroberungsfußball Ball<NN>erobern<V>ung<SUFF><NN>Fußball
messen ung bar	Lärmmessung Lärm<NN>messen<V>ung<SUFF>	Messbarkeitsgrenze messen<V>bar<ADJ><SUFF>keit<SUFF><NN>Grenze
bezahlen ung er	Bezahlungsmethode bezahlen<V>ung<SUFF><NN>Methode	Fahrkartenbezahler Fahrkarte<NN>bezahlen<V>er<SUFF>
verleihen ung er	Medienpreisverleihung Medium<NN>Preis<NN>verleihen<V>ung<SUFF>	Liegestuhlverleiher liegen<V>Stuhl<NN>verleihen<V>er<SUFF>
bekämpfen ung er	Ursachenbekämpfung Ursache<NN>bekämpfen<V>ung<SUFF>	Schnakenbekämpfer Schnake<NN>bekämpfen<V>er<SUFF>
verdichten ung er	Verdichtungsmittel verdichten<V>ung<SUFF><NN>Mittel	Gasverdichter Gas<NN>verdichten<V>er<SUFF>
überwinden ung er	Militarismusüberwindung Militar<NN>ismus<SUFF><NN>überwinden<V>ung<SUFF>	Todesüberwinder Tod<NN>überwinden<V>er<SUFF>
stören ung er	Störungswelle stören<V>ung<SUFF><NN>Welle	Friedensstörer Frieden<NN>stören<V>er<SUFF>
verändern ung er	Wetterveränderung Wetter<NN>verändern<V>ung<SUFF>	Weltveränderer Welt<NN>verändern<V>er<SUFF>
entschärfen ung er	Entschärfungsversuch entschärfen<V>ung<SUFF><NN>Versuch	Entschärfergruppe entschärfen<V>er<SUFF><NN>Gruppe
verlängern ung er	Mandatsverlängerung Mandat<NN>verlängern<V>ung<SUFF>	Laufzeitverlängerer laufen<V>Zeit<NN>verlängern<V>er<SUFF>
begrenzen er ung	Temperaturbegrenzer Temperatur<NN>begrenzen<V>er<SUFF>	Begrenzungshütchen begrenzen<V>ung<SUFF><NN>Hut<NN>chen<SUFF>
verschwenden ung er	Raumverschwendungspathos Raum<NN>verschwenden<V>ung<SUFF><NN>Pathos	Chancenverschwender Chance<NN>verschwenden<V>er<SUFF>
enteisen ung er	Enteisungshalle enteisen<V>ung<SUFF><NN>Halle	Türschlossenteiser Türe<NN>Schloss<NN>enteisen<V>er<SUFF>
betreuen er ung	Ersatzbetreuerin Ersatz<NN>betreuen<V>er<SUFF><NN>in<SUFF>	Kurzzeitbetreuung kurz<ADJ>Zeit<NN>betreuen<V>ung<SUFF>
unterwerfen ung er	Unterwerfungspose unterwerfen<V>ung<SUFF><NN>Pose	Naturunterwerfer Natur<NN>unterwerfen<V>er<SUFF>
privatisieren ung er	Privatisierungslogik privatisieren<V>ung<SUFF><NN>Logik	Wohnungsprivatisierer Wohnung<NN>privatisieren<V>er<SUFF>
verpflegen ung er	Verpflegungsmöglichkeit verpflegen<V>ung<SUFF><NN>Möglichkeit	Selbstverpflegerhaus selbst<ADJ>verpflegen<V>er<SUFF><NN>Haus
restrukturieren ung er	Restrukturierungsfachmann restrukturieren<V>ung<SUFF><NN>Fachmann	Finanzrestrukturierer Finanz<NN>restrukturieren<V>er<SUFF>
verschreiben ung er	Medikamentenverschreibung Medikament<NN>verschreiben<V>ung<SUFF>	Pillenverschreiber Pille<NN>verschreiben<V>er<SUFF>
verachten ung er	Geldverachtung Geld<NN>verachten<V>ung<SUFF>	Kostverächter Kost<NN>verachten<V>er<SUFF>
verwerten ung er	Fremdtextverwertung fremd<ADJ>Text<NN>verwerten<V>ung<SUFF>	Resteverwerter Rest<NN>verwerten<V>er<SUFF>
verwerten er bar	Resteverwerter Rest<NN>verwerten<V>er<SUFF>	Gerichtsverwertbarkeit Gericht<NN>verwerten<V>bar<ADJ><SUFF>keit<SUFF>
plündern er ung	Museumsplünderer Museum<NN>plündern<V>er<SUFF>	Plünderungsaktion plündern<V>ung<SUFF><NN>Aktion
deuten ung er	Schädeldeutung Schädel<NN>deuten<V>ung<SUFF>	Leichendeuter Leiche<NN>deuten<V>er<SUFF>
begründen ung er	Daseinsbegründung Dasein<NN>begründen<V>ung<SUFF>	Heilhausbegründerin heilen<V>Haus<NN>begründen<V>er<SUFF><NN>in<SUFF>
verpacken ung er	Drogenverpackungsmaterial Droge<NN>verpacken<V>ung<SUFF><NN>Material	Industrieverpacker Industrie<NN>verpacken<V>er<SUFF>
wirtschaften er ung	Finanzwirtschafter Finanz<NN>wirtschaften<V>er<SUFF>	Waldwirtschaftung Wald<NN>wirtschaften<V>ung<SUFF>
drehen er ung	Kerzendreher Kerze<NN>drehen<V>er<SUFF>	Trancedrehung Trance<NN>drehen<V>ung<SUFF>
vergiften er ung	Trinkwasservergifter trinken<V>Wasser<NN>vergiften<V>er<SUFF>	Fischvergiftung Fisch<NN>vergiften<V>ung<SUFF>
bündeln ung er	Informationsbündelung Information<NN>bündeln<V>ung<SUFF>	Wirtschaftsbündler Wirtschaft<NN>bündeln<V>er<SUFF>
erfrischen ung er	Erfrischungsaspekt erfrischen<V>ung<SUFF><NN>Aspekt	Lufterfrischer Luft<NN>erfrischen<V>er<SUFF>
töten ung er	Tötungsversuch töten<V>ung<SUFF><NN>Versuch	Schlangentöter Schlange<NN>töten<V>er<SUFF>
übersetzen ung er	Übersetzungssprache übersetzen<V>ung<SUFF><NN>Sprache	Übersetzerforum übersetzen<V>er<SUFF><NN>Forum
dehnen ung er	Muskeldehnung Muskel<NN>dehnen<V>ung<SUFF>	Lederdehner Leder<NN>dehnen<V>er<SUFF>
vergewaltigen ung er	Vergewaltigungsvorwurf vergewaltigen<V>ung<SUFF><NN>Vorwurf	Serienvergewaltiger Serie<NN>vergewaltigen<V>er<SUFF>
unterbrechen ung er	Prozessunterbrechung Prozess<NN>unterbrechen<V>ung<SUFF>	Unterbrecherkontakt unterbrechen<V>er<SUFF><NN>Kontakt
klassifizieren ung er	Altersklassifizierung Alter<NN>klassifizieren<V>ung<SUFF>	Schiffsklassifizierer Schiff<NN>klassifizieren<V>er<SUFF>
vertuschen ung er	Vertuschungsgefahr vertuschen<V>ung<SUFF><NN>Gefahr	Vertuschertruppe vertuschen<V>er<SUFF><NN>Truppe
erheben ung er	Blitzerhebung Blitz<NN>erheben<V>ung<SUFF>	Datenerheber Datum<NN>erheben<V>er<SUFF>
testen er ung	Alkoholtester Alkohol<NN>testen<V>er<SUFF>	Allergietestung Allergie<NN>testen<V>ung<SUFF>
verwenden ung er	Verwendungsweise verwenden<V>ung<SUFF><NN>Weise	Sprachverwender Sprache<NN>verwenden<V>er<SUFF>
verleugnen ung er	Holocaustverleugnung Holocaust<NN>verleugnen<V>ung<SUFF>	Realitätsverleugner Realität<NN>verleugnen<V>er<SUFF>
verhüten er ung	Papstverhüter Papst<NN>verhüten<V>er<SUFF>	Verhütungspflaster verhüten<V>ung<SUFF><NN>Pflaster
koordinieren ung er	Spielplankoordinierung Spiel<NN>Plan<NN>koordinieren<V>ung<SUFF>	Fahrplankoordinierer Fahrplan<NN>koordinieren<V>er<SUFF>
bohren ung er	Geothermiebohrung Ge<NN>o<SUFF><NN>Therm<NN>ie<SUFF><NN>bohren<V>ung<SUFF>	Akkubohrer Akku<NN>bohren<V>er<SUFF>
besetzen ung er	Gleisbesetzung Gleis<NN>besetzen<V>ung<SUFF>	Flughafenbesetzer Flughafen<NN>besetzen<V>er<SUFF>
prellen ung er	Knieprellung Knie<NN>prellen<V>ung<SUFF>	Zechprellerin zechen<V>prellen<V>er<SUFF><NN>in<SUFF>
fahnden er ung	Personenfahnder Person<NN>fahnden<V>er<SUFF>	Drogenfahndungsbehörde Droge<NN>fahnden<V>ung<SUFF><NN>Behörde
glätten ung er	Kantenglättung Kante<NN>glätten<V>ung<SUFF>	Haarglätter Haar<NN>glätten<V>er<SUFF>
betäuben ung er	Betäubungspistole betäuben<V>ung<SUFF><NN>Pistole	Tierbetäuber Tier<NN>betäuben<V>er<SUFF>
verschmutzen ung er	Fahrbahnverschmutzung fahren<V>Bahn<NN>verschmutzen<V>ung<SUFF>	Atmosphärenverschmutzer Atmosphäre<NN>verschmutzen<V>er<SUFF>
beschwören ung er	Totenbeschwörung tot<ADJ><SUFF><NN>beschwören<V>ung<SUFF>	Mythenbeschwörer Mythe<NN>beschwören<V>er<SUFF>
vereinfachen ung er	Sprachvereinfachung Sprache<NN>vereinfachen<V>ung<SUFF>	Weltvereinfacher Welt<NN>vereinfachen<V>er<SUFF>
entdecken er ung	Entdeckerreise entdecken<V>er<SUFF><NN>Reise	Entdeckungspotenzial entdecken<V>ung<SUFF><NN>Potenzial
erfinden er ung	Erfinderkarriere erfinden<V>er<SUFF><NN>Karriere	Marketingerfindung Marketing<NN>erfinden<V>ung<SUFF>
lüften er ung	Netzteillüfter Netz<NN>Teil<NN>lüften<V>er<SUFF>	Lüftungsexperte lüften<V>ung<SUFF><NN>Experte
empören ung er	Empörungsabsicht empören<V>ung<SUFF><NN>Absicht	Berufsempörer Beruf<NN>empören<V>er<SUFF>
räumen ung er	Räumungstitel räumen<V>ung<SUFF><NN>Titel	Bombenräumer Bombe<NN>räumen<V>er<SUFF>
betrachten er ung	Betrachterraum betrachten<V>er<SUFF><NN>Raum	Betrachtungsgegenstand betrachten<V>ung<SUFF><NN>Gegenstand
verführen ung er	Verführungskünstler verführen<V>ung<SUFF><NN>Künstler	Tanzverführer Tanz<NN>verführen<V>er<SUFF>
waschen er ung	Flugzeugwäscher Flugzeug<NN>waschen<V>er<SUFF>	Morgenwaschung Morgen<NN>waschen<V>ung<SUFF>
bespannen ung er	Kunststoffbespannung Kunststoff<NN>bespannen<V>ung<SUFF>	Schlägerbespanner Schläger<NN>bespannen<V>er<SUFF>
versenden er ung	Hardwareversender Hardware<NN>versenden<V>er<SUFF>	Aktenversendungsprozess Akte<NN>versenden<V>ung<SUFF><NN>Prozess
zeichnen ung er	Graphitzeichnung Graphit<NN>zeichnen<V>ung<SUFF>	Weichzeichnereffekt weich<ADJ>zeichnen<V>er<NN><SUFF>Effekt
beschleunigen er ung	Geschäftsbeschleuniger Geschäft<NN>beschleunigen<V>er<SUFF>	Tempobeschleunigung Tempo<NN>beschleunigen<V>ung<SUFF>
verursachen er ung	Krankheitsverursacher Krankheit<NN>verursachen<V>er<SUFF>	Brandverursachung Brand<NN>verursachen<V>ung<SUFF>
erfassen ung er	Fragenerfassungssoftware Frage<NN>erfassen<V>ung<SUFF><NN>Software	Datenerfasserin Datum<NN>erfassen<V>er<SUFF><NN>in<SUFF>
versprechen ung er	Wahlkampfversprechung Wahlkampf<NN>versprechen<V>ung<SUFF>	Steuergeschenkeversprecher Steuer<NN>Geschenk<NN>versprechen<V>er<SUFF>
optimieren er ung	Suchmaschinenoptimierer suchen<V>Maschine<NN>optimieren<V>er<SUFF>	Zielgruppenoptimierung Zielgruppe<NN>optimieren<V>ung<SUFF>
markieren ung er	Bahnmarkierung Bahn<NN>markieren<V>ung<SUFF>	Reviermarkierer Revier<NN>markieren<V>er<SUFF>
modernisieren ung er	Modernisierungskurs modernisieren<V>ung<SUFF><NN>Kurs	Staatsmodernisierer Staat<NN>modernisieren<V>er<SUFF>
strafen bar er	Strafbarkeitsschwelle strafen<V>bar<ADJ><SUFF>keit<SUFF><NN>Schwelle	Strafermittler strafen<V>er<SUFF><NN>Mittler
besteigen ung er	Vulkanbesteigung Vulkan<NN>besteigen<V>ung<SUFF>	Bergbesteiger Berg<NN>besteigen<V>er<SUFF>
bremsen ung er	Motorbremsung Motor<NN>bremsen<V>ung<SUFF>	Steuersenkungsbremser Steuer<NN>Senkung<NN>bremsen<V>er<SUFF>
bereinigen ung er	Sachenrechtsbereinigungsgesetz Sache<NN>Recht<NN>bereinigen<V>ung<SUFF><NN>Gesetz	Grenzbereiniger Grenze<NN>bereinigen<V>er<SUFF>
zersetzen ung er	Zersetzungsprodukt zersetzen<V>ung<SUFF><NN>Produkt	Wehrkraftzersetzer Wehr<NN>Kraft<NN>zersetzen<V>er<SUFF>
fluten ung er	Klangflutung Klang<NN>fluten<V>ung<SUFF>	Geldfluter Geld<NN>fluten<V>er<SUFF>
vermehren ung er	Bevölkerungsvermehrung Bevölkerung<NN>vermehren<V>ung<SUFF>	Vermögensvermehrerin Vermögen<NN>vermehren<V>er<SUFF><NN>in<SUFF>
verstellen ung bar	Heckflügelverstellung Heck<NN>Flügel<NN>verstellen<V>ung<SUFF>	Höhenverstellbarkeit Höhe<NN>verstellen<V>bar<ADJ><SUFF>keit<SUFF>
verstellen er bar	Gurthöhenversteller Gurt<NN>Höhe<NN>verstellen<V>er<SUFF>	Höhenverstellbarkeit Höhe<NN>verstellen<V>bar<ADJ><SUFF>keit<SUFF>
umsegeln er ung	Weltumsegler Welt<NN>umsegeln<V>er<SUFF>	Weltumsegelung Welt<NN>umsegeln<V>ung<SUFF>
mobilisieren ung er	Mobilisierungsdynamik mobilisieren<V>ung<SUFF><NN>Dynamik	Massenmobilisierer Masse<NN>mobilisieren<V>er<SUFF>
schleusen er ung	Schleuserkriminalität schleusen<V>er<SUFF><NN>Kriminalität	Schleusungswasser schleusen<V>ung<SUFF><NN>Wasser
bewilligen ung er	Betriebsbewilligung Betrieb<NN>bewilligen<V>ung<SUFF>	Kriegskreditbewilliger Krieg<NN>Kredit<NN>bewilligen<V>er<SUFF>
unterzeichnen ung er	Unterzeichnungsakt unterzeichnen<V>ung<SUFF><NN>Akt	Unterzeichnerliste unterzeichnen<V>er<SUFF><NN>Liste
erfüllen ung er	Erfüllungsrate erfüllen<V>ung<SUFF><NN>Rate	Wunscherfüllertag Wunsch<NN>erfüllen<V>er<SUFF><NN>Tag
verwirren ung er	Verwirrungszustand verwirren<V>ung<SUFF><NN>Zustand	Liebesverwirrer Liebe<NN>verwirren<V>er<SUFF>
tätowieren er ung	Tätowiererszene tätowieren<V>er<NN><SUFF>Szene	Großflächentätowierung groß<ADJ>Fläche<NN>tätowieren<V>ung<SUFF>
bestäuben ung er	Bestäubungsleistung bestäuben<V>ung<SUFF><NN>Leistung	Blütenbestäuber Blüte<NN>bestäuben<V>er<SUFF>
erschüttern ung er	Erschütterungsvermögen erschüttern<V>ung<SUFF><NN>Vermögen	Bühnenerschütterer Bühne<NN>erschüttern<V>er<SUFF>
wiederholen ung er	Wiederholungsfalle wiederholen<V>ung<SUFF><NN>Falle	Wahlwiederholer Wahl<NN>wiederholen<V>er<SUFF>
bewirtschaften ung er	Personalbewirtschaftung Personal<NN>bewirtschaften<V>ung<SUFF>	Wasserbewirtschafter Wasser<NN>bewirtschaften<V>er<SUFF>
bemalen ung er	Hautbemalung Haut<NN>bemalen<V>ung<SUFF>	Körperbemalerin Körper<NN>bemalen<V>er<SUFF><NN>in<SUFF>
entschlüsseln ung er	Genentschlüsselung Gen<NN>entschlüsseln<V>ung<SUFF>	Hobbyentschlüssler Hobby<NN>entschlüsseln<V>er<SUFF>
zerlegen er ung	Feinzerlegerin fein<ADJ>zerlegen<V>er<SUFF><NN>in<SUFF>	Figurenzerlegung Figur<NN>zerlegen<V>ung<SUFF>
beliefern ung er	Ladenbelieferung Laden<NN>beliefern<V>ung<SUFF>	Apothekenbelieferer Apotheke<NN>beliefern<V>er<SUFF>
vertreiben er ung	Stromvertreiber Strom<NN>vertreiben<V>er<SUFF>	Zuschauervertreibung Zuschauer<NN>vertreiben<V>ung<SUFF>
maximieren ung er	Schadensmaximierung Schaden<NN>maximieren<V>ung<SUFF>	Profitmaximierer Profit<NN>maximieren<V>er<SUFF>
zügeln er ung	Appetitzügler Appetit<NN>zügeln<V>er<SUFF>	Finanzmarktzügelung Finanz<NN>Markt<NN>zügeln<V>ung<SUFF>
vergrößern er ung	Weltvergrößerer Welt<NN>vergrößern<V>er<SUFF>	Vergrößerungsmuster vergrößern<V>ung<SUFF><NN>Muster
mästen er ung	Stiermäster Stier<NN>mästen<V>er<SUFF>	Zwangsmästung Zwang<NN>mästen<V>ung<SUFF>
veredeln ung er	Gemüseveredelung Gemüse<NN>veredeln<V>ung<SUFF>	Oberflächenveredler Oberfläche<NN>veredeln<V>er<SUFF>
befeuchten er ung	Warmluftbefeuchter warm<ADJ>Luft<NN>befeuchten<V>er<SUFF>	Atemluftbefeuchtung Atem<NN>Luft<NN>befeuchten<V>ung<SUFF>
verzweigen ung er	Wurzelverzweigung Wurzel<NN>verzweigen<V>ung<SUFF>	Kabelverzweiger Kabel<NN>verzweigen<V>er<SUFF>
leugnen er ung	Holocaustleugnerin Holocaust<NN>leugnen<V>er<SUFF><NN>in<SUFF>	Gottesleugnung Gott<NN>leugnen<V>ung<SUFF>
beschicken er ung	Standbeschickerin Stand<NN>beschicken<V>er<SUFF><NN>in<SUFF>	Beschickungsanlage beschicken<V>ung<SUFF><NN>Anlage
beschallen ung er	Lautsprecherbeschallung Lautsprecher<NN>beschallen<V>ung<SUFF>	Diskobeschaller Disko<NN>beschallen<V>er<SUFF>
bändigen er ung	Löwenbändiger Löwe<NN>bändigen<V>er<SUFF>	Marktbändigung Markt<NN>bändigen<V>ung<SUFF>
durchdringen ung er	Sauerstoffdurchdringung Sauerstoff<NN>durchdringen<V>ung<SUFF>	Raumdurchdringer Raum<NN>durchdringen<V>er<SUFF>
verdünnen ung er	Ölverdünnung Öl<NN>verdünnen<V>ung<SUFF>	Blutverdünner Blut<NN>verdünnen<V>er<SUFF>
identifizieren er ung	Filmidentifizierer Film<NN>identifizieren<V>er<SUFF>	Identifizierungsprozess identifizieren<V>ung<SUFF><NN>Prozess
erforschen ung er	Gesinnungserforschung Gesinnung<NN>erforschen<V>ung<SUFF>	Menschenerforscher Mensch<NN>erforschen<V>er<SUFF>
verdunsten ung er	Verdunstungsbecken verdunsten<V>ung<SUFF><NN>Becken	Verdunsterröhrchen verdunsten<V>er<SUFF><NN>Rohr<NN>chen<SUFF>
überqueren ung er	Straßenüberquerung Straße<NN>überqueren<V>ung<SUFF>	Äquatorüberquerer Äquator<NN>überqueren<V>er<SUFF>
schädigen ung er	Schädigungsfall schädigen<V>ung<SUFF><NN>Fall	Klimaschädiger Klima<NN>schädigen<V>er<SUFF>
verformen er ung	Holzverformer Holz<NN>verformen<V>er<SUFF>	Hüftgelenksverformung Hüfte<NN>Gelenk<NN>verformen<V>ung<SUFF>
werden er ung	Werderspieler werden<V>er<SUFF><NN>Spieler	Volkwerdung Volk<NN>werden<V>ung<SUFF>
beschwichtigen ung er	Beschwichtigungsstrategie beschwichtigen<V>ung<SUFF><NN>Strategie	Atombeschwichtiger Atom<NN>beschwichtigen<V>er<SUFF>
berieseln ung er	Medienberieselung Medium<NN>berieseln<V>ung<SUFF>	Babyberiesler Baby<NN>berieseln<V>er<SUFF>
verschlüsseln ung er	Verschlüsselungsnetzwerk verschlüsseln<V>ung<SUFF><NN>Netzwerk	Textverschlüsseler Text<NN>verschlüsseln<V>er<SUFF>
sortieren ung er	Eiersortierung Ei<NN>sortieren<V>ung<SUFF>	Zellsortierer Zelle<NN>sortieren<V>er<SUFF>
bekunden ung er	Aufmerksamkeitsbekundung Aufmerksamkeit<NN>bekunden<V>ung<SUFF>	Beileidsbekunder Beileid<NN>bekunden<V>er<SUFF>
konvertieren ung bar	Konvertierungspflicht konvertieren<V>ung<SUFF><NN>Pflicht	Goldkonvertierbarkeit Gold<NN>konvertieren<V>bar<ADJ><SUFF>keit<SUFF>
vertilgen er ung	Schädlingsvertilger Schädling<NN>vertilgen<V>er<SUFF>	Unkrautvertilgungsmittel Unkraut<NN>vertilgen<V>ung<SUFF><NN>Mittel
vergeben er ung	Notenvergeber Note<NN>vergeben<V>er<SUFF>	Namensvergebung Name<NN>vergeben<V>ung<SUFF>
verwechseln bar er	Unverwechselbarkeitstheater un<PREF>verwechseln<V>bar<ADJ><SUFF>keit<SUFF><NN>Theater	Wagenverwechsler Wagen<NN>verwechseln<V>er<SUFF>
verwechseln ung er	Verwechslungsgrundlage verwechseln<V>ung<SUFF><NN>Grundlage	Wagenverwechsler Wagen<NN>verwechseln<V>er<SUFF>
erwecken ung er	Erweckungsdrama erwecken<V>ung<SUFF><NN>Drama	Wiedererwecker wieder<VPART>erwecken<V>er<SUFF>
versuchen ung er	Weihnachtsversuchung Weihnacht<NN>versuchen<V>ung<SUFF>	Frauenversucher Frau<NN>versuchen<V>er<SUFF>
durchsuchen bar ung	Volltextdurchsuchbarkeit voll<ADJ>Text<NN>durchsuchen<V>bar<ADJ><SUFF>keit<SUFF>	Fahrzeugdurchsuchung Fahrzeug<NN>durchsuchen<V>ung<SUFF>
benoten ung er	Benotungssystem benoten<V>ung<SUFF><NN>System	Zeitungsbenoter Zeitung<NN>benoten<V>er<SUFF>
erzielen ung er	Profiterzielung Profit<NN>erzielen<V>ung<SUFF>	Torerzieler Tor<NN>erzielen<V>er<SUFF>
modellieren ung er	Risikomodellierung Risiko<NN>modellieren<V>ung<SUFF>	Klimamodellierer Klima<NN>modellieren<V>er<SUFF>
trösten er ung	Witwentröster Witwe<NN>trösten<V>er<SUFF>	Tröstungsversuch trösten<V>ung<SUFF><NN>Versuch
beantworten er ung	Beschwerdebriefbeantworter Beschwerde<NN>Brief<NN>beantworten<V>er<SUFF>	Anfragenbeantwortung an<VPART>fragen<V><SUFF><NN>beantworten<V>ung<SUFF>
verzerren ung er	Wirklichkeitsverzerrungsfeld wirklich<ADJ>keit<SUFF><NN>verzerren<V>ung<SUFF><NN>Feld	Gesangverzerrer Gesang<NN>verzerren<V>er<SUFF>
sagen er ung	Neinsager Nein<NN>sagen<V>er<SUFF>	Danksagung Dank<NN>sagen<V>ung<SUFF>
vernebeln ung er	Vernebelungstechnik vernebeln<V>ung<SUFF><NN>Technik	Chancenvernebler Chance<NN>vernebeln<V>er<SUFF>
bräunen ung er	Hautbräunung Haut<NN>bräunen<V>ung<SUFF>	Selbstbräunerfarbe selbst<ADJ>bräunen<V>er<SUFF><NN>Farbe
zähmen er ung	Verkehrszähmer Verkehr<NN>zähmen<V>er<SUFF>	Zähmungszeit zähmen<V>ung<SUFF><NN>Zeit
beschweren er ung	Briefbeschwerer Brief<NN>beschweren<V>er<SUFF>	Beschwerungstopf beschweren<V>ung<SUFF><NN>Topf
verlangsamen ung er	Wachstumsverlangsamung Wachstum<NN>verlangsamen<V>ung<SUFF>	Spielverlangsamer Spiel<NN>verlangsamen<V>er<SUFF>
kartieren ung er	Zieselkartierung Ziesel<NN>kartieren<V>ung<SUFF>	Profikartierer Profi<NN>kartieren<V>er<SUFF>
verladen ung er	Rübenverladung Rübe<NN>verladen<V>ung<SUFF>	Gepäckverlader Gepäck<NN>verladen<V>er<SUFF>
zertifizieren ung er	Zertifizierungswut zertifizieren<V>ung<SUFF><NN>Wut	Wanderwegzertifizierer Wanderweg<NN>zertifizieren<V>er<SUFF>
veröden ung er	Nervenverödung Nerv<NN>veröden<V>ung<SUFF>	Revolutionsveröder Revolution<NN>veröden<V>er<SUFF>
verpesten er ung	Büroklimaverpester Büro<NN>Klima<NN>verpesten<V>er<SUFF>	Luftverpestung Luft<NN>verpesten<V>ung<SUFF>
erhitzen ung er	Erhitzungsphase erhitzen<V>ung<SUFF><NN>Phase	Gasdurchlauferhitzer Gas<NN>durch<VPART>laufen<V>erhitzen<V>er<SUFF>
verfeinern ung er	Geschmacksverfeinerung Geschmack<NN>verfeinern<V>ung<SUFF>	Käseverfeinerer Käse<NN>verfeinern<V>er<SUFF>
beschädigen ung er	Datenbeschädigung Datum<NN>beschädigen<V>ung<SUFF>	Sachbeschädiger Sache<NN>beschädigen<V>er<SUFF>
verpachten er ung	Gastronomieverpächter Gastronomie<NN>verpachten<V>er<SUFF>	Landverpachtung Land<NN>verpachten<V>ung<SUFF>
schmieren ung er	Kettenschmierung Kette<NN>schmieren<V>ung<SUFF>	Farbschmierer Farbe<NN>schmieren<V>er<SUFF>
festigen ung er	Festigungsprozess festigen<V>ung<SUFF><NN>Prozess	Steinfestiger Stein<NN>festigen<V>er<SUFF>
positionieren ung er	Achsenpositionierung Achse<NN>positionieren<V>ung<SUFF>	Schlafpositionierer Schlaf<NN>positionieren<V>er<SUFF>
beauftragen er ung	Fanbeauftrager Fan<NN>beauftragen<V>er<SUFF>	Beauftragungstext beauftragen<V>ung<SUFF><NN>Text
umarmen ung er	Umarmungsversuch umarmen<V>ung<SUFF><NN>Versuch	Weltumarmer Welt<NN>umarmen<V>er<SUFF>
benennen ung er	Urheberbenennung Urheber<NN>benennen<V>ung<SUFF>	Straßenbenenner Straße<NN>benennen<V>er<SUFF>
verwirklichen ung er	Glücksverwirklichung Glück<NN>verwirklichen<V>ung<SUFF>	Traumverwirklicher Traum<NN>verwirklichen<V>er<SUFF>
kompostieren er ung	Scheinkompostierer Schein<NN>kompostieren<V>er<SUFF>	Kompostierungsanlage kompostieren<V>ung<SUFF><NN>Anlage
löschen er ung	Feuerwehrlöscher Feuerwehr<NN>löschen<V>er<SUFF>	Löschungsanspruch löschen<V>ung<SUFF><NN>Anspruch
polstern er ung	Industriepolsterer Industrie<NN>polstern<V>er<SUFF>	Bügelpolsterung Bügel<NN>polstern<V>ung<SUFF>
legen er ung	Fliesenlegerin Fliese<NN>legen<V>er<NN><SUFF>in<SUFF>	Fundamentlegung Fundament<NN>legen<V>ung<SUFF>
verkürzen ung er	Bahnverkürzung Bahn<NN>verkürzen<V>ung<SUFF>	Schaltwegeverkürzer schalten<V>Weg<NN>verkürzen<V>er<SUFF>
erschleichen er ung	Leistungserschleicher Leistung<NN>erschleichen<V>er<SUFF>	Titelerschleichung Titel<NN>erschleichen<V>ung<SUFF>
hinterziehen ung er	Steuerhinterziehungsverfahren Steuer<NN>hinterziehen<V>ung<SUFF><NN>Verfahren	Steuerhinterzieherin Steuer<NN>hinterziehen<V>er<SUFF><NN>in<SUFF>
überschreiten ung er	Datenüberschreitung Datum<NN>überschreiten<V>ung<SUFF>	Grenzüberschreiter Grenze<NN>überschreiten<V>er<SUFF>
verleumden ung er	Verleumdungskampagne verleumden<V>ung<SUFF><NN>Kampagne	Verleumderportal verleumden<V>er<NN><SUFF>Portal
ausrüsten er ung	Golfausrüster Golf<NN>aus<VPART>rüsten<V>er<SUFF>	Ausrüstungsgeilheit aus<VPART>rüsten<V>ung<NN><SUFF>geil<ADJ>heit<SUFF>
umkreisen er ung	Weltumkreiser Welt<NN>umkreisen<V>er<SUFF>	Mondumkreisung Mond<NN>umkreisen<V>ung<SUFF>
verstromen ung er	Holzverstromung Holz<NN>verstromen<V>ung<SUFF>	Atomverstromer Atom<NN>verstromen<V>er<SUFF>
radieren ung er	Farbradierung Farbe<NN>radieren<V>ung<SUFF>	Malerradierer Maler<NN>radieren<V>er<SUFF>
verdummen ung er	Publikumsverdummung Publikum<NN>verdummen<V>ung<SUFF>	Volksverdummer Volk<NN>verdummen<V>er<SUFF>
verschönern ung er	Verschönerungsverein verschönern<V>ung<SUFF><NN>Verein	Haarverschönerer Haar<NN>verschönern<V>er<SUFF>
umrunden ung er	Sonnenumrundung Sonne<NN>umrunden<V>ung<SUFF>	Weltumrunder Welt<NN>umrunden<V>er<SUFF>
verschränken ung er	Quantenverschränkung Quantum<NN>verschränken<V>ung<SUFF>	Zungenverschränker Zunge<NN>verschränken<V>er<SUFF>
biegen ung er	Flussbiegung Fluss<NN>biegen<V>ung<SUFF>	Eisenbieger Eisen<NN>biegen<V>er<SUFF>
entblößen ung er	Entblößungsgeschichte entblößen<V>ung<SUFF><NN>Geschichte	Schulterentblößer Schulter<NN>entblößen<V>er<SUFF>
wärmen er ung	Ohrenwärmer Ohr<NN>wärmen<V>er<SUFF>	Erdwärmung Erde<NN>wärmen<V>ung<SUFF>
zerstäuben er ung	Zerstäuberpumpe zerstäuben<V>er<SUFF><NN>Pumpe	Spritzerstäubung Sprit<NN>zerstäuben<V>ung<SUFF>
bejahen er ung	Lebensbejaher Leben<NN>bejahen<V>er<SUFF>	Bejahungsversuch bejahen<V>ung<SUFF><NN>Versuch
verbiegen ung er	Körperverbiegungsnummer Körper<NN>verbiegen<V>ung<SUFF><NN>Nummer	Faktenverbieger Faktum<NN>verbiegen<V>er<SUFF>
entwerten er ung	Fahrkartenentwerter Fahrkarte<NN>entwerten<V>er<SUFF>	Geldentwertung Geld<NN>entwerten<V>ung<SUFF>
beladen ung er	Fahrzeugbeladung Fahrzeug<NN>beladen<V>ung<SUFF>	Flugzeugbelader Flugzeug<NN>beladen<V>er<SUFF>
verdampfen ung er	Verdampfungsanlage verdampfen<V>ung<SUFF><NN>Anlage	Rotationsverdampfer Rotation<NN>verdampfen<V>er<SUFF>
verdrehen er ung	Wortverdreher Wort<NN>verdrehen<V>er<SUFF>	Geschichtsverdrehung Geschichte<NN>verdrehen<V>ung<SUFF>
peinigen ung er	Publikumspeinigung Publikum<NN>peinigen<V>ung<SUFF>	Peinigerfamilie peinigen<V>er<NN><SUFF>Familie
verkünden ung er	Urteilverkündung Urteil<NN>verkünden<V>ung<SUFF>	Untergangsverkünder Untergang<NN>verkünden<V>er<SUFF>
köpfen ung er	Köpfungsakt köpfen<V>ung<SUFF><NN>Akt	Köpfergott köpfen<V>er<SUFF><NN>Gott
befähigen ung er	Laufbahnbefähigung Laufbahn<NN>befähigen<V>ung<SUFF>	Technologiebefähiger Technologie<NN>befähigen<V>er<SUFF>
bewundern ung er	Bewunderungsmodus bewundern<V>ung<SUFF><NN>Modus	Wolkenbewunderer Wolke<NN>bewundern<V>er<SUFF>
erreichen ung bar	Minimalzielerreichung minimal<ADJ>Ziel<NN>erreichen<V>ung<SUFF>	Nichterreichbarkeit nicht<PREF>erreichen<V>bar<ADJ><SUFF>keit<SUFF>
reformieren ung er	Programmreformierung Programm<NN>reformieren<V>ung<SUFF>	Opernreformierer Oper<NN>reformieren<V>er<SUFF>
übersiedeln er ung	Übersiedlerhilfe übersiedeln<V>er<SUFF><NN>Hilfe	Übersiedlungsanzeige übersiedeln<V>ung<SUFF><NN>Anzeige
verkuppeln er ung	Verkupplerin verkuppeln<V>er<SUFF><NN>in<SUFF>	Verkuppelungsversuch verkuppeln<V>ung<SUFF><NN>Versuch
zertrümmern ung er	Zertrümmerungsaktion zertrümmern<V>ung<SUFF><NN>Aktion	Klassikzertrümmerer Klassik<NN>zertrümmern<V>er<SUFF>
bewachen er ung	Spezialbewacher spezial<ADJ>bewachen<V>er<SUFF>	Standbewachung Stand<NN>bewachen<V>ung<SUFF>
erschaffen er ung	Weltenerschaffer Welt<NN>erschaffen<V>er<SUFF>	Charaktererschaffung Charakter<NN>erschaffen<V>ung<SUFF>
kumulieren ung er	Machtkumulierung Macht<NN>kumulieren<V>ung<SUFF>	Wolkenkumulierer Wolke<NN>kumulieren<V>er<SUFF>
harmonisieren ung er	Patentrechtsharmonisierung patent<ADJ>Recht<NN>harmonisieren<V>ung<SUFF>	Geschichtsharmonisierer Geschichte<NN>harmonisieren<V>er<SUFF>
verfälschen ung er	Wettbewerbsverfälschung Wettbewerb<NN>verfälschen<V>ung<SUFF>	Geschichtsverfälscher Geschichte<NN>verfälschen<V>er<SUFF>
brandstiften er ung	Serienbrandstifter Serie<NN>brandstiften<V>er<SUFF>	Brandstiftungsversuch brandstiften<V>ung<SUFF><NN>Versuch
hetzen er ung	Kommunistenhetzer Kommune<NN>ist<SUFF><NN>hetzen<V>er<SUFF>	Volkshetzung Volk<NN>hetzen<V>ung<SUFF>
relativieren er ung	Holocaustrelativierer Holocaust<NN>relativieren<V>er<SUFF>	Relativierungsmanöver relativieren<V>ung<SUFF><NN>Manöver
orten er ung Echoorter Echo<NN>orten<V>er<SUFF>	Satellitenortung Satellit<NN>orten<V>ung<SUFF>
skalieren bar ung	Skalierbarkeitsversprechen skalieren<V>bar<ADJ><SUFF>keit<SUFF><NN>Versprechen	Skalierungsfläche skalieren<V>ung<SUFF><NN>Fläche
betonieren ung er	Betonierungswut betonieren<V>ung<SUFF><NN>Wut	Betoniererfraktion betonieren<V>er<SUFF><NN>Fraktion
zerfleischen er ung	Selbstzerfleischerin selbst<ADJ>zerfleischen<V>er<SUFF><NN>in<SUFF>	Zerfleischungsprozess zerfleischen<V>ung<SUFF><NN>Prozess
umfliegen ung er	Südumfliegung Süd<NN>umfliegen<V>ung<SUFF>	Weltumflieger Welt<NN>umfliegen<V>er<SUFF>
härten ung er	Stahlhärtung Stahl<NN>härten<V>ung<SUFF>	Nagelhärter Nagel<NN>härten<V>er<SUFF>
wuchern ung er	Bindegewebswucherung binden<V>Gewebe<NN>wuchern<V>ung<SUFF>	Kreditwucherer Kredit<NN>wuchern<V>er<SUFF>
veranlassen ung er	Veranlassungsprinzip veranlassen<V>ung<SUFF><NN>Prinzip	Zweckveranlasser Zweck<NN>veranlassen<V>er<SUFF>
verneinen ung er	Konsumverneinung Konsum<NN>verneinen<V>ung<SUFF>	Vaterlandsverneiner Vaterland<NN>verneinen<V>er<SUFF>
verdicken ung er	Herzmuskelverdickung Herz<NN>Muskel<NN>verdicken<V>ung<SUFF>	Lebensmittelverdicker Lebensmittel<NN>verdicken<V>er<SUFF>
horten er ung	Liquiditätshorter Liquidität<NN>horten<V>er<SUFF>	Datenhortung Datum<NN>horten<V>ung<SUFF>
punzieren er ung	Lederpunzierer Leder<NN>punzieren<V>er<SUFF>	Punzierungsgesetz punzieren<V>ung<SUFF><NN>Gesetz
verhütten ung er	Kupferverhüttungsanlage Kupfer<NN>verhütten<V>ung<SUFF><NN>Anlage	Aluminiumverhütter Aluminium<NN>verhütten<V>er<SUFF>
fräsen ung er	Gelenkfräsung Gelenk<NN>fräsen<V>ung<SUFF>	Eisfräser Eis<NN>fräsen<V>er<SUFF>
zerkleinern er ung	Industriezerkleinerer Industrie<NN>zerkleinern<V>er<SUFF>	Zerkleinerungsprozess zerkleinern<V>ung<SUFF><NN>Prozess
